併	倂
俞	兪
俱	倶
值	値
偷	偸
劫	刧
即	卽
啓	啟
填	塡
夐	敻
妍	姸
媪	媼
媮	婾
将	將
尔	尓
尚	尙
屏	屛
巔	巓
并	幷
强	強
敘	敍
教	敎
既	旣
晚	晩
查	査
栈	桟
榆	楡
殼	殻
沉	沈
清	淸
溉	漑
熙	煕
瓶	甁
真	眞
着	著
研	硏
緒	緖
衆	眾
訮	詽
豜	豣
迸	逬
鎮	鎭
青	靑
顛	顚
飲	飮
高	髙