丟	丟
並	幷
亙	亙
佇	佇
佈	佈
佔	佔
併	倂
倂	倂
侶	侶
侷	侷
俞	兪
俁	俁
係	係
俬	俬
俱	倶
倖	倖
值	値
偷	偸
傢	傢
傯	傯
儘	侭
兌	兌
內	內
冊	冊
冪	冪
凜	凜
別	別
刪	刪
勻	勻
卽	卽
即	卽
吒	吒
吳	吳
吶	吶
呂	呂
唸	唸
嚥	嚥
囪	囪
塗	塗
填	塡
墰	墰
壯	壯
夐	敻
夠	夠
奧	奧
奼	奼
妍	姸
妝	妝
姍	姍
娛	娛
媪	媼
媮	婾
宮	宮
寀	寀
将	將
尚	尙
屆	屆
屏	屛
帯	帯
廈	廈
廝	廝
廳	庁
弒	弒
弔	弔
強	強
强	強
彆	彆
彔	彔
彥	彥
恆	恆
悅	悅
悞	悞
悽	悽
慄	慄
慼	慼
慾	慾
戶	戶
拋	拋
挩	挩
挱	挱
捨	捨
捲	捲
掙	掙
採	採
揯	揯
搖	搖
搵	搵
敎	敎
教	敎
敓	敓
敘	敍
旣	旣
晉	晉
晚	晩
朮	朮
柵	柵
査	査
查	査
棧	桟
梲	梲
榲	榲
榆	楡
橫	橫
毀	毀
氳	氳
氾	氾
汎	汎
汙	汙
決	決
沉	沈
沒	沒
沖	沖
況	況
泝	泝
涗	涗
涼	涼
淒	淒
淥	淥
淨	淨
淩	淩
清	淸
渙	渙
減	減
湊	湊
溉	漑
溫	溫
濛	濛
熅	熅
熙	煕
燬	燬
爭	爭
爾	尓
尔	尓
瓶	甁
痠	痠
癒	癒
盃	盃
盜	盜
眞	眞
真	眞
睏	睏
睜	睜
睪	睪
瞭	瞭
矇	矇
研	硏
硃	硃
祕	祕
祿	祿
稅	稅
穩	穏
粵	粵
羨	羨
脫	脫
臥	臥
苧	苧
茲	茲
荊	荊
着	著
蔥	蔥
薀	薀
虛	虛
蛻	蛻
術	朮
衕	衕
衚	衚
衝	沖
訮	詽
豜	豣
跡	跡
迴	迴
迸	逬
週	週
遊	遊
遡	遡
鉅	钜
隱	隠
青	靑
靜	靜
韁	韁
餘	馀
高	髙
黃	黃
一目瞭然	一目瞭然
不瞭解	不瞭解
乾乾淨淨	干干淨淨
傢俱	傢俱
彷彿	彷彿
據瞭解	据瞭解
明瞭	明瞭
瞭如	瞭如
瞭然於心	瞭然于心
瞭如指掌	瞭如指掌
瞭解	瞭解
瞭解到	瞭解到
簡單明瞭	简单明瞭
衹見樹木	衹见树木
衹見樹木不見森林	衹见树木不见森林
踅門瞭戶	踅门瞭戶
